ID,Seq,3st_LC_Score,3st_RC_Score,3st_Total_Score,학습목표,학습방법,강의 학습 교재 유형,학습빈도,기출문제 공부 횟수,취약분야 인지 여부,토익 모의테스트 횟수,1st_LC_Score,1st_RC_Score,1st_Total_Score,2st_LC_Score,2st_RC_Score,2st_Total_Score,Gender,Birth_Year,Score_diff_total
1,3,345,336,681,승진,온라인강의,영상 교재,주5-6회,7.0,1,10,181,173,354,227,213,440,1,1973,241
2,3,380,368,748,승진,온라인강의,뉴스/이슈 기반 교재,주5-6회,4.0,1,14,330,290,620,354,339,693,2,1982,55
3,3,416,382,798,자기계발,참고서,일반적인 영어 텍스트 기반 교재,주1-2회,4.0,1,4,367,309,676,396,365,761,2,1995,37
4,3,495,397,892,승진,온라인강의,뉴스/이슈 기반 교재,주3-4회,9.0,1,8,470,285,755,495,341,836,1,1987,56
5,3,398,437,835,자기계발,온라인강의,영상 교재,주3-4회,6.0,1,4,273,372,645,314,426,740,1,1994,95
6,3,445,352,797,취업,온라인강의,영상 교재,주5-6회,9.0,1,7,360,256,616,372,269,641,2,1997,156
7,3,495,382,877,자기계발,오프라인강의,비즈니스 시뮬레이션(Role Play),주1-2회,4.0,1,4,487,337,824,495,341,836,2,1990,41
8,3,145,135,280,자기계발,오프라인강의,비즈니스 시뮬레이션(Role Play),주3-4회,7.0,0,7,132,129,261,133,130,263,1,1973,17
9,3,354,457,811,승진,온라인강의,뉴스/이슈 기반 교재,주5-6회,8.0,1,10,256,369,625,322,425,747,1,1994,64
10,3,423,346,769,승진,온라인강의,영상 교재,주5-6회,8.0,1,8,358,279,637,382,305,687,2,1984,82
11,3,457,309,766,자기계발,참고서,일반적인 영어 텍스트 기반 교재,주1-2회,3.0,1,6,447,234,681,452,297,749,2,1991,17
12,3,368,476,844,자기계발,온라인강의,뉴스/이슈 기반 교재,주3-4회,5.0,1,6,300,413,713,332,445,777,1,2007,67
13,3,484,429,913,승진,참고서,일반적인 영어 텍스트 기반 교재,주5-6회,6.0,1,9,406,321,727,443,388,831,1,1991,82
14,3,470,342,812,승진,참고서,일반적인 영어 텍스트 기반 교재,주5-6회,8.0,1,7,432,273,705,469,310,779,2,1986,33
15,3,490,329,819,자기계발,온라인강의,뉴스/이슈 기반 교재,주3-4회,4.0,1,6,487,235,722,489,265,754,2,2005,65
16,3,469,488,957,자기계발,오프라인강의,비즈니스 시뮬레이션(Role Play),주3-4회,6.0,1,5,465,400,865,466,429,895,1,1990,62
17,3,472,464,936,자기계발,온라인강의,뉴스/이슈 기반 교재,주3-4회,4.0,1,5,437,403,840,440,432,872,1,1999,64
18,3,435,495,930,자기계발,온라인강의,영상 교재,주5-6회,8.0,1,9,363,454,817,392,455,847,2,2005,83
19,3,440,439,879,자기계발,오프라인강의,비즈니스 시뮬레이션(Role Play),주5-6회,7.0,1,8,370,339,709,436,375,811,2,1992,68
20,3,295,295,590,승진,오프라인강의,비즈니스 시뮬레이션(Role Play),매일(주 7회),10.0,1,6,174,275,449,245,279,524,1,1995,66
21,3,432,428,860,자기계발,온라인강의,영상 교재,주3-4회,5.0,1,7,359,331,690,415,387,802,2,1997,58
22,3,401,325,726,자기계발,오프라인강의,비즈니스 시뮬레이션(Role Play),주1-2회,2.0,1,4,336,267,603,359,283,642,1,1988,84
23,3,472,409,881,승진,참고서,일반적인 영어 텍스트 기반 교재,주5-6회,6.0,1,8,469,289,758,471,380,851,2,1984,30
24,3,391,322,713,취업,온라인강의,영상 교재,주1-2회,3.0,1,4,306,231,537,308,239,547,1,2002,166
25,3,348,480,828,자기계발,온라인강의,뉴스/이슈 기반 교재,주5-6회,5.0,0,9,322,478,800,340,479,819,2,1992,9
26,3,433,449,882,자기계발,오프라인강의,비즈니스 시뮬레이션(Role Play),주3-4회,6.0,1,7,369,385,754,399,415,814,1,1998,68
27,3,327,429,756,자기계발,온라인강의,뉴스/이슈 기반 교재,주3-4회,4.0,0,8,255,357,612,280,382,662,2,1991,94
28,3,383,415,798,자기계발,오프라인강의,비즈니스 시뮬레이션(Role Play),매일(주 7회),9.0,1,14,309,341,650,334,366,700,1,1985,98
29,3,371,457,828,자기계발,온라인강의,영상 교재,주3-4회,4.0,1,8,290,376,666,320,406,726,2,1986,102
30,3,483,416,899,승진,온라인강의,비즈니스 시뮬레이션(Role Play),주1-2회,2.0,1,4,474,339,813,475,390,865,1,1986,34
31,3,482,412,894,승진,참고서,일반적인 영어 텍스트 기반 교재,주3-4회,5.0,1,10,476,334,810,479,391,870,2,1985,24
32,3,461,460,921,자기계발,온라인강의,영상 교재,매일(주 7회),9.0,0,17,355,355,710,404,403,807,1,1993,114
33,3,404,476,880,자기계발,온라인강의,영상 교재,주3-4회,3.0,1,6,341,413,754,368,440,808,2,2006,72
34,3,436,386,822,자기계발,온라인강의,영상 교재,주3-4회,4.0,1,8,368,318,686,400,350,750,1,2007,72
35,3,360,426,786,자기계발,온라인강의,영상 교재,주1-2회,2.0,1,5,291,357,648,328,394,722,2,2000,64
36,3,382,308,690,승진,참고서,일반적인 영어 텍스트 기반 교재,주1-2회,2.0,0,5,328,248,576,380,300,680,1,1983,10
37,3,426,327,753,자기계발,참고서,일반적인 영어 텍스트 기반 교재,주1-2회,2.0,1,3,353,251,604,421,319,740,2,2004,13
38,3,493,389,882,자기계발,참고서,일반적인 영어 텍스트 기반 교재,주5-6회,7.0,1,12,447,314,761,491,358,849,1,1993,33
39,3,392,320,712,자기계발,참고서,일반적인 영어 텍스트 기반 교재,주1-2회,1.0,1,4,357,282,639,389,314,703,2,2003,9
40,3,343,281,624,자기계발,온라인강의,영상 교재,주3-4회,6.0,1,12,277,242,519,307,245,552,1,2003,72
41,3,416,339,755,자기계발,참고서,일반적인 영어 텍스트 기반 교재,주1-2회,2.0,1,5,413,240,653,415,324,739,2,2000,16
42,3,412,485,897,자기계발,참고서,일반적인 영어 텍스트 기반 교재,주1-2회,3.0,1,7,297,482,779,399,484,883,1,2002,14
43,3,454,381,835,승진,온라인강의,뉴스/이슈 기반 교재,주5-6회,7.0,1,14,371,298,669,417,344,761,2,1995,74
44,3,331,349,680,자기계발,참고서,일반적인 영어 텍스트 기반 교재,주1-2회,1.0,1,3,289,307,596,326,344,670,1,2006,10
45,3,495,495,990,자기계발,오프라인강의,비즈니스 시뮬레이션(Role Play),주3-4회,6.0,1,11,431,484,915,495,488,983,2,1982,7
46,3,319,296,615,승진,오프라인강의,비즈니스 시뮬레이션(Role Play),주1-2회,2.0,1,4,283,241,524,295,272,567,1,1973,48
47,3,322,354,676,승진,오프라인강의,비즈니스 시뮬레이션(Role Play),주3-4회,4.0,0,8,262,294,556,283,315,598,2,1988,78
48,3,495,387,882,자기계발,참고서,일반적인 영어 텍스트 기반 교재,매일(주 7회),8.0,1,18,494,236,730,495,349,844,1,1990,38
49,3,495,375,870,자기계발,참고서,일반적인 영어 텍스트 기반 교재,주1-2회,2.0,1,5,492,310,802,493,342,835,2,1995,35
50,3,348,339,687,승진,오프라인강의,비즈니스 시뮬레이션(Role Play),주3-4회,3.0,1,6,279,290,569,309,300,609,1,1994,78
51,3,456,450,906,취업,온라인강의,영상 교재,주5-6회,7.0,1,15,362,327,689,363,357,720,2,1999,186
52,3,346,378,724,승진,참고서,일반적인 영어 텍스트 기반 교재,주1-2회,2.0,1,4,283,325,608,335,377,712,1,1998,12
53,3,475,369,844,자기계발,참고서,일반적인 영어 텍스트 기반 교재,주1-2회,1.0,1,3,440,329,769,472,361,833,2,2007,11
54,3,408,303,711,자기계발,참고서,일반적인 영어 텍스트 기반 교재,주3-4회,4.0,1,8,371,266,637,398,293,691,1,2007,20
55,3,452,406,858,승진,온라인강의,뉴스/이슈 기반 교재,주5-6회,6.0,1,12,407,286,693,415,369,784,2,1994,74
56,3,334,344,678,승진,참고서,일반적인 영어 텍스트 기반 교재,주5-6회,8.0,1,15,289,297,586,319,328,647,1,1994,31
57,3,353,452,805,자기계발,온라인강의,영상 교재,주3-4회,5.0,0,9,271,399,670,302,400,702,2,1986,103
58,3,358,494,852,승진,오프라인강의,비즈니스 시뮬레이션(Role Play),주3-4회,4.0,1,7,270,430,700,302,462,764,1,1987,88
59,3,433,491,924,승진,오프라인강의,비즈니스 시뮬레이션(Role Play),주3-4회,5.0,0,6,266,486,752,375,489,864,2,1986,60
60,3,431,327,758,자기계발,온라인강의,뉴스/이슈 기반 교재,주5-6회,6.0,1,10,349,245,594,379,275,654,1,1984,104
61,3,392,392,784,승진,오프라인강의,비즈니스 시뮬레이션(Role Play),주5-6회,7.0,1,8,360,317,677,362,358,720,2,1984,64
62,3,452,392,844,자기계발,온라인강의,뉴스/이슈 기반 교재,주5-6회,7.0,0,8,448,309,757,449,320,769,1,2006,75
63,3,338,329,667,승진,참고서,일반적인 영어 텍스트 기반 교재,주3-4회,6.0,1,9,287,307,594,328,322,650,2,1992,17
64,3,479,474,953,취업,참고서,일반적인 영어 텍스트 기반 교재,매일(주 7회),8.0,1,15,312,435,747,380,440,820,1,1997,133
65,3,468,307,775,자기계발,온라인강의,뉴스/이슈 기반 교재,주1-2회,2.0,1,4,465,242,707,467,253,720,2,2002,55
66,3,449,481,930,자기계발,온라인강의,뉴스/이슈 기반 교재,주3-4회,5.0,1,9,295,477,772,355,480,835,1,1991,95
67,3,320,394,714,자기계발,참고서,일반적인 영어 텍스트 기반 교재,주1-2회,3.0,0,4,324,332,656,300,374,674,2,1996,40
68,3,444,357,801,자기계발,참고서,일반적인 영어 텍스트 기반 교재,주5-6회,6.0,1,7,381,291,672,413,326,739,1,1998,62
69,3,376,351,727,자기계발,오프라인강의,비즈니스 시뮬레이션(Role Play),주5-6회,7.0,1,13,313,321,634,324,325,649,2,1988,78
70,3,232,225,457,자기계발,참고서,일반적인 영어 텍스트 기반 교재,주5-6회,7.0,1,12,181,174,355,201,194,395,1,1990,62
71,3,321,438,759,자기계발,참고서,일반적인 영어 텍스트 기반 교재,주3-4회,4.0,1,6,279,396,675,310,427,737,2,2006,22
72,3,382,378,760,자기계발,온라인강의,뉴스/이슈 기반 교재,주5-6회,7.0,1,10,319,319,638,325,321,646,1,1993,114
73,3,382,409,791,승진,온라인강의,뉴스/이슈 기반 교재,주5-6회,8.0,1,12,316,327,643,321,328,649,2,1981,142
74,3,338,470,808,승진,참고서,일반적인 영어 텍스트 기반 교재,주5-6회,5.0,0,10,259,467,726,309,468,777,1,1997,31
75,3,465,485,950,취업,온라인강의,영상 교재,주1-2회,2.0,1,3,371,328,699,419,365,784,2,1996,166
76,3,291,209,500,자기계발,참고서,일반적인 영어 텍스트 기반 교재,매일(주 7회),10.0,1,17,254,124,378,286,194,480,1,1985,20
77,3,387,412,799,자기계발,온라인강의,뉴스/이슈 기반 교재,주1-2회,3.0,1,2,365,312,677,378,358,736,2,2006,63
78,3,321,328,649,자기계발,오프라인강의,비즈니스 시뮬레이션(Role Play),주1-2회,1.0,1,4,297,287,584,317,321,638,1,1994,11
79,3,337,283,620,승진,오프라인강의,비즈니스 시뮬레이션(Role Play),주3-4회,5.0,1,9,307,253,560,327,278,605,2,1984,15
80,3,337,360,697,자기계발,참고서,일반적인 영어 텍스트 기반 교재,매일(주 7회),9.0,1,20,273,296,569,307,330,637,1,1989,60
81,3,337,424,761,승진,오프라인강의,비즈니스 시뮬레이션(Role Play),주3-4회,5.0,1,11,261,348,609,308,395,703,2,1991,58
82,3,431,356,787,자기계발,온라인강의,뉴스/이슈 기반 교재,주1-2회,2.0,1,4,362,287,649,412,314,726,1,1993,61
83,3,291,152,443,자기계발,참고서,일반적인 영어 텍스트 기반 교재,주1-2회,1.0,1,5,285,84,369,286,147,433,2,2000,10
84,3,495,445,940,자기계발,온라인강의,뉴스/이슈 기반 교재,주3-4회,6.0,0,13,488,378,866,493,383,876,1,1999,64
85,3,337,312,649,자기계발,참고서,일반적인 영어 텍스트 기반 교재,주5-6회,7.0,1,15,269,267,536,331,301,632,2,1988,17
86,3,315,334,649,승진,오프라인강의,비즈니스 시뮬레이션(Role Play),주5-6회,7.0,1,16,309,321,630,312,332,644,1,1990,5
87,3,278,331,609,자기계발,오프라인강의,비즈니스 시뮬레이션(Role Play),주5-6회,7.0,1,13,153,228,381,200,275,475,2,1992,134
88,3,495,495,990,자기계발,오프라인강의,비즈니스 시뮬레이션(Role Play),주3-4회,3.0,1,13,424,456,880,487,495,982,1,1986,8
89,3,355,494,849,승진,오프라인강의,비즈니스 시뮬레이션(Role Play),주3-4회,4.0,1,8,255,451,706,297,493,790,2,1992,59
90,3,220,213,433,승진,참고서,일반적인 영어 텍스트 기반 교재,주3-4회,4.0,1,7,190,186,376,201,198,399,1,1989,34
91,3,322,327,649,자기계발,온라인강의,영상 교재,주1-2회,2.0,1,2,301,328,629,321,321,642,2,1993,7
92,3,495,495,990,자기계발,온라인강의,영상 교재,주3-4회,5.0,1,10,491,479,970,495,495,990,1,2007,0
93,3,327,322,649,승진,온라인강의,뉴스/이슈 기반 교재,주5-6회,6.0,1,8,274,264,538,312,289,601,2,1987,48
94,3,468,438,906,취업,온라인강의,영상 교재,주5-6회,4.0,0,15,370,330,700,375,345,720,1,1992,186
95,3,339,433,772,자기계발,참고서,일반적인 영어 텍스트 기반 교재,주1-2회,1.0,1,2,293,395,688,330,432,762,2,2005,10
96,3,495,495,990,취업,온라인강의,영상 교재,주1-2회,2.0,1,3,433,442,875,443,453,896,1,1994,94
97,3,454,396,850,자기계발,온라인강의,영상 교재,주3-4회,4.0,1,8,451,235,686,452,294,746,2,1975,104
98,3,319,331,650,자기계발,온라인강의,뉴스/이슈 기반 교재,매일(주 7회),10.0,1,18,298,291,589,301,325,626,1,2006,24
99,3,420,387,807,자기계발,온라인강의,뉴스/이슈 기반 교재,주1-2회,2.0,1,4,392,351,743,393,360,753,2,2006,54
100,3,395,395,790,자기계발,참고서,일반적인 영어 텍스트 기반 교재,주1-2회,2.0,1,1,355,365,720,380,390,770,1,1994,20
101,3,351,318,669,자기계발,오프라인강의,뉴스/이슈 기반 교재,주3-4회,5.0,1,9,303,268,571,322,278,600,2,2002,69
102,3,316,327,643,승진,오프라인강의,비즈니스 시뮬레이션(Role Play),주3-4회,3.0,1,7,198,312,510,309,331,640,1,1984,3
103,3,382,431,813,자기계발,참고서,일반적인 영어 텍스트 기반 교재,주1-2회,1.0,1,4,290,429,719,373,430,803,2,2005,10
104,3,410,354,764,자기계발,참고서,일반적인 영어 텍스트 기반 교재,주5-6회,5.0,1,12,293,281,574,351,301,652,1,1990,112
105,3,295,295,590,자기계발,온라인강의,뉴스/이슈 기반 교재,주5-6회,4.0,1,15,253,285,538,262,286,548,2,2005,42
106,3,468,473,941,승진,오프라인강의,비즈니스 시뮬레이션(Role Play),주3-4회,5.0,1,6,373,470,843,412,471,883,1,1986,58
107,3,365,394,759,자기계발,온라인강의,영상 교재,주3-4회,5.0,1,9,311,341,652,314,342,656,2,1990,103
108,3,495,495,990,자기계발,참고서,일반적인 영어 텍스트 기반 교재,주1-2회,2.0,1,2,348,448,796,495,467,962,1,1995,28
109,3,495,495,990,자기계발,참고서,일반적인 영어 텍스트 기반 교재,주3-4회,4.0,1,8,491,475,966,495,495,990,2,1989,0
110,3,495,495,990,자기계발,온라인강의,영상 교재,매일(주 7회),9.0,1,19,475,470,945,495,495,990,1,1994,0
111,3,411,458,869,자기계발,온라인강의,영상 교재,주3-4회,6.0,1,17,344,391,735,359,406,765,2,1987,104
112,3,354,378,732,자기계발,오프라인강의,비즈니스 시뮬레이션(Role Play),주3-4회,6.0,1,7,264,287,551,310,334,644,1,1976,88
113,3,488,433,921,자기계발,오프라인강의,비즈니스 시뮬레이션(Role Play),매일(주 7회),9.0,1,18,485,235,720,486,337,823,2,1995,98
114,3,434,373,807,자기계발,온라인강의,영상 교재,주3-4회,6.0,1,5,377,317,694,382,322,704,1,1988,103
115,3,340,309,649,승진,온라인강의,뉴스/이슈 기반 교재,주5-6회,7.0,1,14,318,303,621,325,305,630,2,1992,19
116,3,357,465,822,승진,오프라인강의,비즈니스 시뮬레이션(Role Play),주5-6회,6.0,1,11,281,389,670,323,431,754,1,1981,68
117,3,450,475,925,자기계발,온라인강의,영상 교재,매일(주 7회),8.0,1,20,437,307,744,438,374,812,2,1994,113
118,3,280,294,574,자기계발,오프라인강의,비즈니스 시뮬레이션(Role Play),주1-2회,2.0,1,2,255,193,448,279,217,496,1,1986,78
119,3,388,397,785,자기계발,참고서,일반적인 영어 텍스트 기반 교재,매일(주 7회),9.0,1,17,329,338,667,358,367,725,2,1997,60
120,3,424,341,765,자기계발,참고서,일반적인 영어 텍스트 기반 교재,주3-4회,4.0,1,6,347,310,657,399,316,715,1,1996,50
121,3,454,437,891,자기계발,오프라인강의,비즈니스 시뮬레이션(Role Play),주3-4회,5.0,1,7,409,281,690,410,393,803,2,1996,88
122,3,295,237,532,자기계발,참고서,일반적인 영어 텍스트 기반 교재,주3-4회,6.0,1,11,278,156,434,295,187,482,1,1986,50
123,3,432,467,899,자기계발,온라인강의,영상 교재,주3-4회,3.0,1,7,293,429,722,330,466,796,2,1992,103
124,3,253,293,546,승진,온라인강의,뉴스/이슈 기반 교재,주3-4회,5.0,1,10,159,262,421,189,292,481,1,1983,65
125,3,490,429,919,자기계발,오프라인강의,영상 교재,주1-2회,1.0,1,4,486,271,757,487,339,826,2,1998,93
126,3,463,391,854,승진,오프라인강의,비즈니스 시뮬레이션(Role Play),매일(주 7회),9.0,1,16,458,233,691,459,327,786,1,1992,68
127,3,315,321,636,자기계발,온라인강의,영상 교재,주3-4회,2.0,1,7,293,276,569,315,315,630,2,1993,6
128,3,466,364,830,취업,온라인강의,영상 교재,주5-6회,6.0,1,14,341,239,580,373,271,644,1,1993,186
129,3,456,457,913,자기계발,오프라인강의,영상 교재,주1-2회,1.0,1,3,452,310,762,453,367,820,2,1990,93
130,3,394,398,792,승진,온라인강의,영상 교재,매일(주 7회),10.0,1,16,305,310,615,352,331,683,1,1985,109
131,3,310,335,645,자기계발,온라인강의,뉴스/이슈 기반 교재,주1-2회,1.0,1,3,257,265,522,272,280,552,2,2004,93
132,3,398,470,868,승진,온라인강의,뉴스/이슈 기반 교재,주5-6회,7.0,1,15,329,407,736,361,447,808,1,1983,60
133,3,398,325,723,승진,오프라인강의,영상 교재,주3-4회,4.0,1,12,331,258,589,361,288,649,2,1992,74
134,3,379,319,698,자기계발,온라인강의,일반적인 영어 텍스트 기반 교재,주5-6회,6.0,1,14,317,252,569,356,291,647,1,1995,51
135,3,402,381,783,자기계발,오프라인강의,영상 교재,주1-2회,1.0,1,3,319,298,617,356,335,691,2,1988,92
136,3,411,472,883,자기계발,온라인강의,뉴스/이슈 기반 교재,주3-4회,5.0,1,6,305,451,756,344,452,796,1,1996,87
137,3,326,316,642,자기계발,온라인강의,영상 교재,주3-4회,3.0,1,6,269,251,520,295,278,573,2,1982,69
138,3,396,317,713,자기계발,온라인강의,뉴스/이슈 기반 교재,주3-4회,3.0,1,7,332,254,586,364,285,649,1,2004,64
139,3,295,297,592,취업,오프라인강의,영상 교재,주5-6회,6.0,1,16,272,239,511,273,268,541,2,1997,51
140,3,331,368,699,자기계발,온라인강의,뉴스/이슈 기반 교재,주5-6회,9.0,0,15,278,295,573,321,331,652,1,2001,47
141,3,395,395,790,자기계발,참고서,일반적인 영어 텍스트 기반 교재,주1-2회,1.0,1,4,344,393,737,395,395,790,2,1992,0
142,3,295,295,590,승진,오프라인강의,비즈니스 시뮬레이션(Role Play),매일(주 7회),8.0,1,20,262,273,535,295,295,590,1,1993,0
143,3,447,372,819,자기계발,온라인강의,뉴스/이슈 기반 교재,주3-4회,4.0,1,8,381,306,687,408,333,741,2,1984,78
144,3,494,493,987,승진,오프라인강의,비즈니스 시뮬레이션(Role Play),주3-4회,4.0,1,14,386,439,825,438,491,929,1,1993,58
145,3,376,489,865,자기계발,참고서,일반적인 영어 텍스트 기반 교재,매일(주 7회),8.0,1,17,260,486,746,317,487,804,2,1992,61
146,3,493,464,957,자기계발,오프라인강의,비즈니스 시뮬레이션(Role Play),주1-2회,1.0,1,4,457,364,821,465,414,879,1,1980,78
147,3,352,446,798,자기계발,참고서,뉴스/이슈 기반 교재,주3-4회,7.0,1,15,273,441,714,292,442,734,2,2004,64
148,3,295,295,590,자기계발,온라인강의,뉴스/이슈 기반 교재,주3-4회,5.0,1,11,262,273,535,295,295,590,1,1993,0
149,3,377,474,851,자기계발,참고서,일반적인 영어 텍스트 기반 교재,주1-2회,1.0,1,4,320,417,737,357,454,811,2,1991,40
150,3,476,374,850,자기계발,오프라인강의,뉴스/이슈 기반 교재,주3-4회,2.0,1,5,403,300,703,444,342,786,1,2004,64
151,3,348,461,809,자기계발,온라인강의,뉴스/이슈 기반 교재,주5-6회,6.0,0,15,275,388,663,311,424,735,2,2004,74
152,3,395,395,790,승진,오프라인강의,영상 교재,주3-4회,4.0,1,8,367,328,695,368,387,755,1,1982,35
153,3,471,492,963,승진,오프라인강의,영상 교재,주5-6회,7.0,1,13,361,442,803,400,481,881,2,1983,82
154,3,292,263,555,자기계발,참고서,일반적인 영어 텍스트 기반 교재,매일(주 7회),9.0,1,18,289,163,452,290,235,525,1,2000,30
155,3,338,447,785,자기계발,오프라인강의,비즈니스 시뮬레이션(Role Play),주1-2회,2.0,1,3,284,393,677,299,408,707,2,1990,78
156,3,411,381,792,승진,온라인강의,영상 교재,매일(주 7회),10.0,1,20,339,310,649,357,337,694,1,1999,98
157,3,357,353,710,자기계발,온라인강의,영상 교재,주3-4회,3.0,1,6,289,285,574,321,317,638,2,2005,72
158,3,475,395,870,승진,오프라인강의,비즈니스 시뮬레이션(Role Play),매일(주 7회),8.0,0,19,464,234,698,467,334,801,1,1999,69
159,3,401,326,727,승진,참고서,일반적인 영어 텍스트 기반 교재,주5-6회,6.0,1,10,335,260,595,386,311,697,2,1981,30
160,3,280,284,564,승진,온라인강의,영상 교재,주3-4회,2.0,1,4,210,241,451,230,261,491,1,1986,73
161,3,384,329,713,승진,온라인강의,비즈니스 시뮬레이션(Role Play),주3-4회,6.0,1,11,308,253,561,355,300,655,2,2002,58
162,3,361,468,829,취업,온라인강의,뉴스/이슈 기반 교재,주3-4회,4.0,1,6,272,380,652,277,385,662,1,1994,167
163,3,381,390,771,자기계발,오프라인강의,뉴스/이슈 기반 교재,주3-4회,3.0,1,6,314,323,637,334,343,677,2,1989,94
164,3,348,350,698,자기계발,오프라인강의,비즈니스 시뮬레이션(Role Play),주1-2회,1.0,1,2,268,270,538,309,311,620,1,1988,78
165,3,316,402,718,자기계발,온라인강의,뉴스/이슈 기반 교재,주3-4회,5.0,0,14,254,340,594,269,355,624,2,1996,94
166,3,357,456,813,자기계발,참고서,일반적인 영어 텍스트 기반 교재,매일(주 7회),9.0,1,11,310,409,719,342,441,783,1,2007,30
167,3,393,394,787,승진,오프라인강의,비즈니스 시뮬레이션(Role Play),주1-2회,2.0,1,4,278,367,645,348,391,739,2,1998,48
168,3,338,333,671,자기계발,온라인강의,뉴스/이슈 기반 교재,주3-4회,4.0,1,6,276,271,547,291,286,577,1,1985,94
169,3,391,444,835,승진,온라인강의,영상 교재,주3-4회,3.0,0,8,280,441,721,319,442,761,2,1989,74
170,3,295,295,590,승진,오프라인강의,비즈니스 시뮬레이션(Role Play),주3-4회,4.0,1,8,222,240,462,295,295,590,1,1997,0
171,3,423,485,908,승진,오프라인강의,비즈니스 시뮬레이션(Role Play),주3-4회,4.0,1,8,342,404,746,394,456,850,2,1991,58
172,3,419,390,809,승진,참고서,뉴스/이슈 기반 교재,주5-6회,7.0,1,13,352,323,675,382,353,735,1,1991,74
173,3,363,386,749,자기계발,참고서,뉴스/이슈 기반 교재,주3-4회,5.0,1,10,291,374,665,301,384,685,2,2005,64
174,3,343,478,821,승진,온라인강의,영상 교재,주3-4회,2.0,1,3,286,398,684,306,442,748,1,1990,73
175,3,351,419,770,승진,오프라인강의,일반적인 영어 텍스트 기반 교재,주1-2회,2.0,1,3,314,382,696,346,414,760,2,1983,10
176,3,463,320,783,승진,참고서,일반적인 영어 텍스트 기반 교재,주5-6회,6.0,1,16,410,239,649,462,291,753,1,1977,30
177,3,383,371,754,자기계발,오프라인강의,뉴스/이슈 기반 교재,주3-4회,4.0,1,12,321,309,630,336,324,660,2,1980,94
178,3,470,469,939,취업,참고서,일반적인 영어 텍스트 기반 교재,주5-6회,7.0,1,11,300,431,731,337,468,805,1,1995,134
179,3,408,453,861,자기계발,온라인강의,영상 교재,주5-6회,6.0,1,12,299,346,645,351,397,748,2,1993,113
180,3,403,438,841,자기계발,온라인강의,비즈니스 시뮬레이션(Role Play),주3-4회,3.0,1,7,344,379,723,359,394,753,1,1983,88
181,3,380,398,778,자기계발,오프라인강의,일반적인 영어 텍스트 기반 교재,주3-4회,3.0,1,10,326,344,670,355,373,728,2,1985,50
182,3,411,382,793,자기계발,온라인강의,영상 교재,주3-4회,6.0,0,11,311,281,592,360,330,690,1,1994,103
183,3,332,290,622,자기계발,오프라인강의,일반적인 영어 텍스트 기반 교재,주1-2회,1.0,1,5,286,243,529,327,285,612,2,2004,10
184,3,280,220,500,승진,참고서,일반적인 영어 텍스트 기반 교재,주5-6회,6.0,1,9,216,156,372,265,205,470,1,1987,30
185,3,494,388,882,자기계발,오프라인강의,비즈니스 시뮬레이션(Role Play),주3-4회,4.0,1,5,449,297,746,450,344,794,2,1986,88
186,3,476,343,819,자기계발,온라인강의,뉴스/이슈 기반 교재,주3-4회,3.0,1,7,439,306,745,444,311,755,1,2007,64
187,3,486,415,901,자기계발,온라인강의,비즈니스 시뮬레이션(Role Play),주5-6회,9.0,1,14,483,246,729,484,319,803,2,1986,98
188,3,310,372,682,자기계발,오프라인강의,일반적인 영어 텍스트 기반 교재,주3-4회,3.0,0,7,302,368,670,306,370,676,1,1993,6
189,3,295,295,590,승진,오프라인강의,비즈니스 시뮬레이션(Role Play),주3-4회,6.0,1,6,113,279,392,269,280,549,2,1993,41
190,3,342,319,661,승진,참고서,일반적인 영어 텍스트 기반 교재,매일(주 7회),9.0,1,18,252,300,552,327,304,631,1,1998,30
191,3,438,456,894,승진,온라인강의,뉴스/이슈 기반 교재,매일(주 7회),10.0,1,15,264,453,717,366,454,820,2,2004,74
192,3,476,431,907,승진,오프라인강의,비즈니스 시뮬레이션(Role Play),주1-2회,2.0,1,3,473,377,850,475,384,859,1,1982,48
193,3,476,470,946,취업,오프라인강의,일반적인 영어 텍스트 기반 교재,주5-6회,6.0,1,16,398,301,699,446,367,813,2,2005,133
194,3,388,447,835,승진,온라인강의,비즈니스 시뮬레이션(Role Play),주3-4회,3.0,1,6,302,362,664,359,418,777,1,1980,58
195,3,412,417,829,자기계발,참고서,일반적인 영어 텍스트 기반 교재,주1-2회,1.0,0,4,405,408,813,409,411,820,2,2002,9
196,3,473,483,956,취업,오프라인강의,영상 교재,주1-2회,2.0,1,4,466,229,695,467,323,790,1,1999,166
197,3,308,362,670,자기계발,오프라인강의,뉴스/이슈 기반 교재,주5-6회,7.0,1,13,269,322,591,271,325,596,2,2007,74
198,3,388,494,882,자기계발,온라인강의,뉴스/이슈 기반 교재,주5-6회,6.0,1,12,310,420,730,334,444,778,1,1986,104
199,3,334,313,647,자기계발,참고서,일반적인 영어 텍스트 기반 교재,주1-2회,2.0,1,3,327,289,616,330,293,623,2,1999,24
200,3,295,295,590,자기계발,오프라인강의,뉴스/이슈 기반 교재,주5-6회,7.0,1,13,262,219,481,277,234,511,1,1981,79
201,3,409,445,854,승진,오프라인강의,영상 교재,매일(주 7회),9.0,1,16,308,424,732,328,443,771,2,1990,83
202,3,440,471,911,자기계발,참고서,일반적인 영어 텍스트 기반 교재,주3-4회,4.0,1,9,426,454,880,431,459,890,1,2007,21
203,3,492,489,981,자기계발,참고서,일반적인 영어 텍스트 기반 교재,주1-2회,1.0,1,2,490,445,935,491,450,941,2,1992,40
204,3,162,253,415,승진,참고서,일반적인 영어 텍스트 기반 교재,주1-2회,2.0,1,3,150,245,395,157,248,405,1,2000,10
205,3,466,430,896,자기계발,온라인강의,뉴스/이슈 기반 교재,주3-4회,3.0,1,5,419,383,802,434,398,832,2,1997,64
206,3,418,437,855,자기계발,참고서,일반적인 영어 텍스트 기반 교재,주3-4회,4.0,1,7,401,423,824,407,428,835,1,2003,20
207,3,306,360,666,승진,오프라인강의,비즈니스 시뮬레이션(Role Play),매일(주 7회),10.0,1,16,265,323,588,272,326,598,2,1982,68
208,3,295,295,590,자기계발,오프라인강의,비즈니스 시뮬레이션(Role Play),주1-2회,2.0,1,3,231,264,495,282,294,576,1,1990,14
209,3,371,482,853,승진,오프라인강의,비즈니스 시뮬레이션(Role Play),매일(주 7회),8.0,1,17,312,423,735,337,448,785,2,1989,68
210,3,277,294,571,자기계발,온라인강의,영상 교재,주5-6회,9.0,1,10,169,196,365,216,243,459,1,1998,112
211,3,455,413,868,자기계발,온라인강의,비즈니스 시뮬레이션(Role Play),주1-2회,1.0,1,4,375,332,707,431,389,820,2,1983,48
212,3,294,294,588,자기계발,오프라인강의,뉴스/이슈 기반 교재,주5-6회,7.0,1,14,292,141,433,293,223,516,1,2003,72
213,3,426,468,894,자기계발,온라인강의,일반적인 영어 텍스트 기반 교재,주1-2회,2.0,1,2,332,454,786,396,458,854,2,1980,40
214,3,295,295,590,자기계발,오프라인강의,영상 교재,주3-4회,4.0,1,8,242,256,498,279,293,572,1,2002,18
215,3,271,284,555,승진,오프라인강의,뉴스/이슈 기반 교재,주5-6회,5.0,1,10,229,242,471,234,247,481,2,1981,74
216,3,345,421,766,자기계발,오프라인강의,일반적인 영어 텍스트 기반 교재,주3-4회,4.0,1,7,309,383,692,336,410,746,1,2006,20
217,3,411,423,834,자기계발,온라인강의,뉴스/이슈 기반 교재,주5-6회,8.0,1,5,334,315,649,339,360,699,2,1987,135
218,3,370,445,815,자기계발,오프라인강의,뉴스/이슈 기반 교재,주3-4회,5.0,1,6,333,408,741,338,413,751,1,2003,64
219,3,453,371,824,자기계발,오프라인강의,뉴스/이슈 기반 교재,주1-2회,2.0,1,3,423,338,761,426,344,770,2,1999,54
220,3,276,281,557,승진,온라인강의,영상 교재,주5-6회,6.0,1,8,272,190,462,275,198,473,1,1986,84
221,3,460,468,928,자기계발,참고서,일반적인 영어 텍스트 기반 교재,주5-6회,7.0,1,12,398,406,804,430,438,868,2,1987,60
222,3,250,203,453,승진,오프라인강의,비즈니스 시뮬레이션(Role Play),매일(주 7회),10.0,1,15,247,127,374,248,135,383,1,1983,70
223,3,495,449,964,자기계발,참고서,일반적인 영어 텍스트 기반 교재,주5-6회,8.0,1,9,490,425,915,495,434,934,2,1992,30
224,3,473,476,949,자기계발,온라인강의,영상 교재,매일(주 7회),9.0,1,18,348,444,792,420,446,866,1,2005,83
225,3,350,316,666,자기계발,참고서,일반적인 영어 텍스트 기반 교재,주3-4회,3.0,1,6,321,287,608,325,291,616,2,1989,50
226,3,226,227,453,자기계발,참고서,일반적인 영어 텍스트 기반 교재,주1-2회,2.0,1,3,138,221,359,221,222,443,1,2003,10
227,3,431,473,904,승진,오프라인강의,비즈니스 시뮬레이션(Role Play),매일(주 7회),10.0,1,16,304,438,742,397,439,836,1,1983,68
228,3,269,282,551,자기계발,온라인강의,뉴스/이슈 기반 교재,매일(주 7회),9.0,1,12,228,239,467,232,245,477,2,2001,74
229,3,469,451,920,자기계발,오프라인강의,비즈니스 시뮬레이션(Role Play),매일(주 7회),7.0,1,18,348,424,772,373,449,822,1,2001,98
230,3,385,320,705,자기계발,온라인강의,뉴스/이슈 기반 교재,주3-4회,3.0,1,6,348,283,631,353,288,641,2,2007,64
231,3,344,335,679,승진,오프라인강의,비즈니스 시뮬레이션(Role Play),주1-2회,2.0,0,3,335,325,660,339,331,670,2,1997,9
232,3,279,239,518,자기계발,오프라인강의,뉴스/이슈 기반 교재,매일(주 7회),10.0,1,17,241,173,414,242,202,444,1,2006,74
233,3,484,486,970,승진,오프라인강의,뉴스/이슈 기반 교재,주5-6회,6.0,1,9,347,471,818,424,472,896,2,1988,74
234,3,495,495,990,자기계발,온라인강의,일반적인 영어 텍스트 기반 교재,주1-2회,1.0,1,5,449,445,894,483,479,962,1,1987,28
235,3,225,274,499,승진,온라인강의,뉴스/이슈 기반 교재,주3-4회,3.0,1,6,160,271,431,162,273,435,2,1981,64
236,3,487,493,980,자기계발,오프라인강의,영상 교재,주5-6회,8.0,1,8,432,458,890,437,460,897,1,2002,83
237,3,386,382,768,승진,오프라인강의,영상 교재,주1-2회,1.0,1,3,275,332,607,324,381,705,2,1985,63
238,3,285,332,617,자기계발,오프라인강의,영상 교재,주1-2회,2.0,0,2,277,323,600,279,327,606,1,1983,11
239,3,248,246,494,자기계발,온라인강의,뉴스/이슈 기반 교재,주3-4회,3.0,1,8,215,141,356,216,214,430,2,2003,64
240,3,244,198,442,승진,온라인강의,뉴스/이슈 기반 교재,주3-4회,5.0,1,4,207,160,367,212,166,378,1,1996,64
241,3,298,281,579,자기계발,참고서,일반적인 영어 텍스트 기반 교재,주1-2회,1.0,1,4,189,190,379,251,249,500,2,1986,79
242,3,289,216,505,승진,온라인강의,뉴스/이슈 기반 교재,주3-4회,3.0,1,6,286,145,431,287,153,440,1,1990,65
243,3,295,295,590,승진,온라인강의,영상 교재,매일(주 7회),7.0,1,18,293,220,513,294,226,520,2,1984,70
244,3,330,342,672,승진,온라인강의,일반적인 영어 텍스트 기반 교재,매일(주 7회),9.0,1,16,283,236,519,295,295,590,1,1999,82
245,3,267,252,519,자기계발,온라인강의,뉴스/이슈 기반 교재,주3-4회,3.0,1,8,199,246,445,207,248,455,2,2001,64
246,3,231,299,530,자기계발,참고서,일반적인 영어 텍스트 기반 교재,주1-2회,1.0,1,3,221,290,511,226,294,520,1,1997,10
247,3,417,437,854,자기계발,온라인강의,영상 교재,주3-4회,3.0,1,5,327,433,760,347,434,781,2,2005,73
248,3,394,376,770,자기계발,온라인강의,비즈니스 시뮬레이션(Role Play),주5-6회,8.0,1,12,341,322,663,345,327,672,1,1980,98
249,3,495,495,990,자기계발,참고서,뉴스/이슈 기반 교재,주5-6회,5.0,1,12,451,490,941,495,495,990,2,1982,0
250,3,370,471,841,자기계발,참고서,일반적인 영어 텍스트 기반 교재,주1-2회,1.0,1,4,302,463,765,365,464,829,1,2006,12
251,3,379,410,789,자기계발,온라인강의,영상 교재,주3-4회,4.0,1,17,319,356,675,327,359,686,2,1981,103
252,3,208,264,472,승진,오프라인강의,비즈니스 시뮬레이션(Role Play),주1-2회,1.0,1,4,157,259,416,161,263,424,1,1986,48
253,3,295,295,590,승진,오프라인강의,비즈니스 시뮬레이션(Role Play),주1-2회,2.0,1,3,276,224,500,295,295,590,2,1990,0
254,3,313,325,638,자기계발,온라인강의,비즈니스 시뮬레이션(Role Play),주5-6회,5.0,0,15,301,313,614,308,317,625,1,1996,13
255,3,424,407,831,자기계발,참고서,일반적인 영어 텍스트 기반 교재,매일(주 7회),10.0,1,14,378,360,738,409,392,801,2,2001,30
256,3,285,286,571,자기계발,오프라인강의,뉴스/이슈 기반 교재,주1-2회,4.0,1,1,257,186,443,258,259,517,1,2004,54
257,3,295,295,590,자기계발,온라인강의,뉴스/이슈 기반 교재,주3-4회,3.0,1,7,268,199,467,269,259,528,2,1995,62
258,3,261,248,509,승진,오프라인강의,영상 교재,주3-4회,4.0,1,7,200,187,387,225,212,437,1,1991,72
259,3,438,480,918,자기계발,참고서,뉴스/이슈 기반 교재,주5-6회,8.0,1,12,319,427,746,386,428,814,2,1989,104
260,3,218,293,511,승진,오프라인강의,비즈니스 시뮬레이션(Role Play),주5-6회,5.0,1,10,143,291,434,151,292,443,1,1994,68
261,3,415,413,828,승진,온라인강의,영상 교재,매일(주 7회),8.0,1,20,346,353,699,373,372,745,2,1982,83
262,3,175,262,437,자기계발,온라인강의,뉴스/이슈 기반 교재,주1-2회,2.0,1,3,116,257,373,125,258,383,1,1998,54
263,3,293,293,586,승진,오프라인강의,비즈니스 시뮬레이션(Role Play),주3-4회,3.0,1,9,198,226,424,250,278,528,2,1988,58
264,3,295,295,590,자기계발,온라인강의,뉴스/이슈 기반 교재,주1-2회,1.0,1,2,246,252,498,276,282,558,1,1995,32
265,3,292,262,554,자기계발,참고서,일반적인 영어 텍스트 기반 교재,매일(주 7회),9.0,1,18,290,168,458,291,232,523,2,2003,31
266,3,385,372,757,자기계발,참고서,일반적인 영어 텍스트 기반 교재,주3-4회,4.0,1,9,335,323,658,374,362,736,1,1989,21
267,3,486,493,979,자기계발,온라인강의,비즈니스 시뮬레이션(Role Play),주5-6회,6.0,1,13,321,475,796,405,476,881,2,2001,98
268,3,489,464,953,자기계발,온라인강의,영상 교재,매일(주 7회),7.0,1,17,432,350,782,433,407,840,1,1988,113
269,3,495,495,990,자기계발,오프라인강의,영상 교재,주5-6회,6.0,1,12,487,433,920,489,438,927,2,1991,63
270,3,275,246,521,승진,오프라인강의,비즈니스 시뮬레이션(Role Play),주1-2회,2.0,1,3,250,216,466,251,222,473,1,1992,48
271,3,294,382,676,자기계발,온라인강의,영상 교재,주1-2회,1.0,1,4,222,379,601,231,380,611,2,2006,65
271,3,294,382,676,자기계발,온라인강의,영상 교재,주1-2회,1.0,1,4,222,379,601,231,380,611,2,2001,65
272,3,387,407,794,승진,오프라인강의,영상 교재,주5-6회,5.0,1,8,303,324,627,345,351,696,1,1998,98
273,3,301,346,647,자기계발,온라인강의,영상 교재,매일(주 7회),10.0,1,13,210,343,553,218,345,563,2,2003,84
274,3,334,257,591,자기계발,참고서,일반적인 영어 텍스트 기반 교재,주5-6회,7.0,1,11,315,235,550,319,242,561,1,2001,30
274,3,334,257,591,자기계발,참고서,일반적인 영어 텍스트 기반 교재,주5-6회,7.0,1,11,315,235,550,319,242,561,1,2006,30
275,3,487,488,975,자기계발,온라인강의,영상 교재,주3-4회,5.0,1,6,433,432,865,435,437,872,2,1982,103
276,3,292,294,586,자기계발,오프라인강의,영상 교재,주3-4회,3.0,1,8,254,184,438,255,258,513,1,2003,73
277,3,409,379,788,승진,오프라인강의,비즈니스 시뮬레이션(Role Play),주1-2회,2.0,1,3,355,325,680,385,355,740,2,1987,48
278,3,414,405,819,승진,오프라인강의,비즈니스 시뮬레이션(Role Play),매일(주 7회),10.0,1,14,405,337,742,408,345,753,1,1990,66
279,3,385,418,803,자기계발,참고서,일반적인 영어 텍스트 기반 교재,주3-4회,4.0,1,6,311,352,663,374,416,790,2,2001,13
280,3,295,295,590,취업,온라인강의,영상 교재,매일(주 7회),9.0,1,18,249,160,409,249,224,473,1,1997,117
281,3,475,429,904,자기계발,참고서,일반적인 영어 텍스트 기반 교재,주1-2회,1.0,0,4,466,416,882,471,423,894,2,1992,10
282,3,176,267,443,자기계발,오프라인강의,일반적인 영어 텍스트 기반 교재,주5-6회,6.0,1,12,145,259,404,151,262,413,1,2006,30
283,3,364,381,745,자기계발,참고서,일반적인 영어 텍스트 기반 교재,주3-4회,3.0,1,7,332,353,685,339,356,695,2,1984,50
284,3,211,244,455,승진,참고서,일반적인 영어 텍스트 기반 교재,주3-4회,3.0,1,8,189,236,425,196,239,435,1,1985,20
285,3,276,290,566,자기계발,참고서,일반적인 영어 텍스트 기반 교재,주3-4회,5.0,1,8,227,241,468,251,265,516,2,1998,50
286,3,279,260,539,자기계발,참고서,일반적인 영어 텍스트 기반 교재,주1-2회,2.0,1,3,240,191,431,274,225,499,1,1994,40
287,3,478,482,960,취업,온라인강의,뉴스/이슈 기반 교재,주3-4회,5.0,1,7,354,358,712,395,399,794,2,1998,166
288,3,276,277,553,승진,오프라인강의,비즈니스 시뮬레이션(Role Play),주3-4회,3.0,1,9,147,235,382,247,248,495,1,1989,58
289,3,333,387,720,자기계발,온라인강의,일반적인 영어 텍스트 기반 교재,매일(주 7회),10.0,1,12,269,383,652,274,386,660,2,1989,60
290,3,432,428,860,자기계발,오프라인강의,영상 교재,주5-6회,7.0,1,11,428,339,767,431,346,777,1,2007,83
291,3,495,495,990,자기계발,온라인강의,영상 교재,주5-6회,5.0,1,13,479,379,858,480,432,912,2,1998,78
292,3,377,493,870,자기계발,오프라인강의,비즈니스 시뮬레이션(Role Play),주1-2회,2.0,1,5,324,491,815,330,492,822,1,1987,48
293,3,264,279,543,자기계발,참고서,일반적인 영어 텍스트 기반 교재,주5-6회,5.0,1,9,187,248,435,234,249,483,2,1989,60
294,3,286,282,568,자기계발,오프라인강의,뉴스/이슈 기반 교재,주3-4회,5.0,0,10,278,269,547,281,275,556,1,1983,12
295,3,399,397,796,승진,오프라인강의,비즈니스 시뮬레이션(Role Play),매일(주 7회),9.0,1,14,335,333,668,365,363,728,2,1984,68
296,3,419,445,864,승진,온라인강의,비즈니스 시뮬레이션(Role Play),주1-2회,1.0,1,4,312,338,650,395,421,816,1,1999,48
297,3,217,351,568,자기계발,오프라인강의,영상 교재,주1-2회,2.0,0,5,202,340,542,208,345,553,2,1984,15
298,3,495,495,990,승진,오프라인강의,영상 교재,주5-6회,8.0,1,13,439,441,880,469,471,940,1,1983,50
299,3,232,226,458,자기계발,온라인강의,뉴스/이슈 기반 교재,주3-4회,4.0,1,8,163,159,322,200,195,395,2,1978,63
300,3,393,379,772,자기계발,온라인강의,뉴스/이슈 기반 교재,주5-6회,7.0,1,12,353,337,690,356,342,698,1,1991,74
301,3,324,362,686,자기계발,온라인강의,뉴스/이슈 기반 교재,주1-2회,2.0,1,3,222,280,502,267,285,552,2,1982,134
302,3,231,225,456,자기계발,참고서,일반적인 영어 텍스트 기반 교재,매일(주 7회),8.0,0,14,213,198,411,217,203,420,1,1989,36
303,3,343,364,707,자기계발,오프라인강의,영상 교재,주1-2회,2.0,1,4,273,264,537,291,289,580,2,1991,127
304,3,295,285,580,승진,온라인강의,뉴스/이슈 기반 교재,주3-4회,3.0,1,10,218,156,374,274,273,547,1,1995,33
305,3,401,403,804,승진,참고서,영상 교재,매일(주 7회),10.0,1,18,330,332,662,360,362,722,2,1974,82
306,3,295,295,590,자기계발,온라인강의,비즈니스 시뮬레이션(Role Play),주5-6회,5.0,1,11,295,223,518,295,232,527,1,1989,63
307,3,266,280,546,자기계발,오프라인강의,뉴스/이슈 기반 교재,주1-2회,1.0,1,4,262,218,480,265,227,492,2,2005,54
308,3,286,262,548,자기계발,오프라인강의,비즈니스 시뮬레이션(Role Play),주5-6회,6.0,1,10,181,164,345,213,198,411,1,1991,137
309,3,252,241,493,승진,오프라인강의,영상 교재,주5-6회,8.0,1,12,178,169,347,198,199,397,2,1987,96
310,3,239,217,456,자기계발,참고서,일반적인 영어 텍스트 기반 교재,매일(주 7회),9.0,1,20,205,179,384,209,187,396,1,1990,60
311,3,269,156,425,승진,온라인강의,비즈니스 시뮬레이션(Role Play),매일(주 7회),8.0,0,16,262,142,404,265,148,413,2,1994,12
312,3,354,372,726,자기계발,온라인강의,뉴스/이슈 기반 교재,주5-6회,6.0,1,12,273,368,641,280,371,651,1,2001,75
313,3,198,258,456,승진,오프라인강의,비즈니스 시뮬레이션(Role Play),매일(주 7회),9.0,1,17,125,254,379,130,257,387,2,1995,69
314,3,141,294,435,자기계발,온라인강의,영상 교재,주1-2회,2.0,0,3,129,292,421,136,293,429,1,1982,6
315,3,272,250,522,자기계발,온라인강의,영상 교재,주1-2회,2.0,1,3,249,170,419,269,190,459,2,1985,63
316,3,295,295,590,자기계발,온라인강의,일반적인 영어 텍스트 기반 교재,주3-4회,3.0,1,8,224,265,489,279,293,572,1,1997,18
317,3,346,386,732,자기계발,참고서,뉴스/이슈 기반 교재,주5-6회,7.0,1,16,267,308,575,309,349,658,2,2007,74
318,3,372,441,813,자기계발,오프라인강의,영상 교재,주5-6회,6.0,1,10,138,327,465,331,400,731,1,2002,82
319,3,287,229,516,자기계발,오프라인강의,비즈니스 시뮬레이션(Role Play),주5-6회,8.0,1,12,236,172,408,238,180,418,2,1988,98
320,3,495,495,990,자기계발,오프라인강의,비즈니스 시뮬레이션(Role Play),주3-4회,3.0,1,7,397,488,885,480,489,969,1,1979,21
321,3,493,445,938,자기계발,온라인강의,일반적인 영어 텍스트 기반 교재,주5-6회,6.0,1,11,491,407,898,492,415,907,2,1998,31
322,3,434,396,830,자기계발,참고서,일반적인 영어 텍스트 기반 교재,매일(주 7회),9.0,1,17,399,351,750,414,366,780,1,1988,50
323,3,439,403,842,자기계발,참고서,일반적인 영어 텍스트 기반 교재,주1-2회,2.0,1,3,431,393,824,434,398,832,2,2001,10
324,3,482,429,911,승진,온라인강의,비즈니스 시뮬레이션(Role Play),주3-4회,6.0,1,10,478,365,843,481,372,853,1,1995,58
325,3,391,492,883,승진,오프라인강의,비즈니스 시뮬레이션(Role Play),매일(주 7회),9.0,1,16,315,490,805,324,491,815,2,1994,68
326,3,261,264,525,자기계발,온라인강의,뉴스/이슈 기반 교재,주3-4회,3.0,0,8,252,255,507,257,259,516,1,1982,9
327,3,443,433,876,자기계발,오프라인강의,영상 교재,매일(주 7회),7.0,1,14,355,427,782,360,432,792,2,2005,84
328,3,460,475,935,승진,오프라인강의,비즈니스 시뮬레이션(Role Play),매일(주 7회),9.0,1,17,458,380,838,458,472,930,1,1994,5
329,3,495,495,990,자기계발,오프라인강의,영상 교재,주1-2회,1.0,1,4,443,411,854,468,436,904,2,1983,86
330,3,314,335,649,자기계발,참고서,일반적인 영어 텍스트 기반 교재,주3-4회,5.0,1,8,297,305,602,300,305,605,1,2002,44
331,3,319,288,607,승진,오프라인강의,비즈니스 시뮬레이션(Role Play),주1-2회,2.0,1,3,296,235,531,300,241,541,2,1974,66
332,3,465,411,876,자기계발,온라인강의,뉴스/이슈 기반 교재,주1-2회,2.0,1,5,461,351,812,464,357,821,1,2005,55
333,3,295,292,587,자기계발,오프라인강의,뉴스/이슈 기반 교재,매일(주 7회),7.0,1,20,248,219,467,256,234,490,2,1997,97
334,3,321,315,636,자기계발,온라인강의,뉴스/이슈 기반 교재,주5-6회,8.0,1,11,298,278,576,312,301,613,1,1990,23
335,3,351,342,693,자기계발,참고서,뉴스/이슈 기반 교재,주3-4회,5.0,1,9,287,290,577,295,295,590,2,1981,103
336,3,439,476,915,승진,온라인강의,영상 교재,주5-6회,5.0,1,9,326,363,689,356,393,749,1,1988,166
337,3,295,295,590,자기계발,온라인강의,비즈니스 시뮬레이션(Role Play),매일(주 7회),10.0,1,18,271,288,559,288,289,577,2,1989,13
338,3,395,395,790,자기계발,오프라인강의,영상 교재,주5-6회,7.0,1,11,220,279,499,227,282,509,1,1988,281
339,3,289,287,576,승진,온라인강의,영상 교재,주5-6회,5.0,1,12,242,241,483,247,246,493,2,1986,83
340,3,273,276,549,자기계발,오프라인강의,영상 교재,주1-2회,2.0,1,5,183,185,368,227,229,456,1,1986,93
341,3,344,331,675,승진,온라인강의,비즈니스 시뮬레이션(Role Play),주5-6회,6.0,1,12,341,250,591,342,263,605,2,1995,70
342,3,408,429,837,자기계발,온라인강의,영상 교재,매일(주 7회),10.0,1,17,405,341,746,406,346,752,1,2004,85
343,3,267,295,562,승진,오프라인강의,비즈니스 시뮬레이션(Role Play),주3-4회,2.0,1,9,105,295,400,209,295,504,2,1988,58
344,3,295,295,590,자기계발,온라인강의,영상 교재,주1-2회,1.0,1,5,233,261,494,283,285,568,1,2003,22
345,3,295,295,590,자기계발,오프라인강의,영상 교재,매일(주 7회),9.0,1,16,250,254,504,274,278,552,2,1985,38
346,3,324,383,707,자기계발,참고서,뉴스/이슈 기반 교재,주1-2회,1.0,0,5,313,370,683,318,376,694,1,2004,13
347,3,269,288,557,승진,오프라인강의,영상 교재,주5-6회,6.0,1,13,185,205,390,227,247,474,2,1993,83
348,3,434,444,878,자기계발,온라인강의,영상 교재,매일(주 7회),8.0,1,20,343,354,697,377,388,765,1,2000,113
349,3,284,225,509,자기계발,참고서,일반적인 영어 텍스트 기반 교재,주1-2회,2.0,1,5,278,214,492,279,220,499,2,2003,10
350,3,358,395,753,승진,오프라인강의,비즈니스 시뮬레이션(Role Play),주3-4회,6.0,1,10,301,384,685,330,392,722,1,1990,31
351,3,371,344,715,자기계발,온라인강의,뉴스/이슈 기반 교재,주5-6회,5.0,1,14,333,278,611,334,307,641,2,2006,74
352,3,295,295,590,자기계발,참고서,일반적인 영어 텍스트 기반 교재,주5-6회,5.0,1,12,249,241,490,290,282,572,1,1982,18
353,3,250,291,541,승진,오프라인강의,비즈니스 시뮬레이션(Role Play),주5-6회,7.0,1,15,150,231,381,216,257,473,2,2000,68
354,3,292,242,534,자기계발,온라인강의,영상 교재,매일(주 7회),9.0,1,16,290,151,441,291,159,450,1,2002,84
355,3,289,252,541,자기계발,오프라인강의,일반적인 영어 텍스트 기반 교재,주3-4회,5.0,1,8,252,214,466,279,241,520,2,2000,21
356,3,278,269,547,자기계발,온라인강의,영상 교재,주1-2회,2.0,1,3,231,176,407,232,223,455,1,1988,92
357,3,165,219,384,자기계발,참고서,일반적인 영어 텍스트 기반 교재,주1-2회,2.0,0,5,152,213,365,158,216,374,2,1988,10
358,3,437,473,910,자기계발,온라인강의,뉴스/이슈 기반 교재,주1-2회,2.0,1,5,394,349,743,395,431,826,1,1984,84
359,3,360,336,696,자기계발,오프라인강의,비즈니스 시뮬레이션(Role Play),주1-2회,1.0,1,6,291,267,558,321,297,618,2,1979,78
360,3,439,405,844,자기계발,온라인강의,뉴스/이슈 기반 교재,주3-4회,4.0,1,5,336,401,737,345,403,748,1,1989,96
361,3,299,282,581,자기계발,참고서,일반적인 영어 텍스트 기반 교재,주1-2회,2.0,1,7,289,271,560,294,276,570,2,1978,11
362,3,373,346,719,자기계발,온라인강의,영상 교재,매일(주 7회),10.0,1,18,370,255,625,371,263,634,1,2003,85
363,3,454,429,883,승진,온라인강의,비즈니스 시뮬레이션(Role Play),주5-6회,8.0,1,14,368,343,711,420,395,815,2,1988,68
364,3,260,261,521,승진,오프라인강의,비즈니스 시뮬레이션(Role Play),주1-2회,2.0,1,4,232,192,424,236,237,473,1,1985,48
365,3,395,395,790,자기계발,오프라인강의,영상 교재,주5-6회,7.0,1,12,382,393,775,387,394,781,2,1981,9
366,3,393,382,775,취업,오프라인강의,영상 교재,주1-2회,1.0,1,6,279,322,601,286,323,609,1,1993,166
367,3,291,395,686,자기계발,참고서,일반적인 영어 텍스트 기반 교재,주3-4회,3.0,1,7,262,395,657,270,395,665,2,2006,21
368,3,395,366,761,자기계발,오프라인강의,뉴스/이슈 기반 교재,주1-2회,2.0,1,4,394,306,700,395,312,707,1,2000,54
369,3,267,385,652,자기계발,온라인강의,일반적인 영어 텍스트 기반 교재,매일(주 7회),10.0,1,19,232,381,613,240,382,622,2,2001,30
370,3,401,406,807,자기계발,온라인강의,뉴스/이슈 기반 교재,주5-6회,7.0,1,16,357,366,723,364,369,733,1,2001,74
371,3,295,273,568,승진,온라인강의,비즈니스 시뮬레이션(Role Play),주3-4회,3.0,1,9,219,217,436,256,237,493,2,1995,75
372,3,295,295,590,자기계발,온라인강의,영상 교재,매일(주 7회),10.0,1,19,258,224,482,287,253,540,1,1996,50
373,3,275,268,543,자기계발,온라인강의,영상 교재,주3-4회,3.0,1,4,224,217,441,239,232,471,2,2003,72
374,3,284,280,564,승진,오프라인강의,영상 교재,주1-2회,2.0,1,6,233,171,404,253,249,502,1,1992,62
375,3,295,295,590,승진,참고서,뉴스/이슈 기반 교재,주3-4회,3.0,1,8,254,246,500,295,295,590,2,1993,0
376,3,244,258,502,자기계발,참고서,일반적인 영어 텍스트 기반 교재,주5-6회,7.0,1,16,198,212,410,229,243,472,1,2004,30
377,3,335,318,653,승진,오프라인강의,비즈니스 시뮬레이션(Role Play),매일(주 7회),10.0,1,16,278,235,513,280,241,521,2,1988,132
378,3,381,422,803,승진,오프라인강의,비즈니스 시뮬레이션(Role Play),주3-4회,4.0,1,9,315,419,734,324,420,744,1,1999,59
379,3,371,395,766,자기계발,온라인강의,영상 교재,매일(주 7회),7.0,1,20,315,339,654,330,354,684,2,2002,82
380,3,215,287,502,승진,참고서,일반적인 영어 텍스트 기반 교재,주5-6회,5.0,1,14,182,281,463,190,282,472,1,1981,30
381,3,295,295,590,승진,온라인강의,비즈니스 시뮬레이션(Role Play),주5-6회,6.0,1,17,282,258,540,295,295,590,2,1983,0
382,3,372,356,728,자기계발,참고서,일반적인 영어 텍스트 기반 교재,매일(주 7회),10.0,1,16,284,331,615,357,341,698,1,2007,30
383,3,248,303,551,자기계발,참고서,뉴스/이슈 기반 교재,주5-6회,5.0,0,10,235,295,530,241,300,541,2,1984,10
384,3,368,379,747,자기계발,온라인강의,영상 교재,주1-2회,2.0,1,3,344,252,596,345,309,654,1,1999,93
385,3,335,347,682,자기계발,오프라인강의,뉴스/이슈 기반 교재,매일(주 7회),10.0,1,13,278,292,570,283,295,578,2,1991,104
386,3,395,395,790,자기계발,온라인강의,비즈니스 시뮬레이션(Role Play),주5-6회,7.0,1,14,371,225,596,372,328,700,1,1992,90
387,3,413,433,846,자기계발,온라인강의,뉴스/이슈 기반 교재,주3-4회,3.0,1,9,329,349,678,366,386,752,2,1981,94
388,3,257,262,519,승진,오프라인강의,비즈니스 시뮬레이션(Role Play),주3-4회,4.0,1,9,253,168,421,256,175,431,1,1986,88
389,3,495,495,990,승진,오프라인강의,비즈니스 시뮬레이션(Role Play),주5-6회,8.0,1,5,363,375,738,456,468,924,2,1997,66
390,3,268,311,579,자기계발,참고서,일반적인 영어 텍스트 기반 교재,매일(주 7회),10.0,1,18,202,308,510,209,310,519,1,2002,60
391,3,437,433,870,자기계발,온라인강의,일반적인 영어 텍스트 기반 교재,주3-4회,3.0,1,4,411,351,762,412,408,820,2,1994,50
392,3,298,295,593,자기계발,참고서,뉴스/이슈 기반 교재,주5-6회,6.0,1,7,244,286,530,278,295,573,1,2005,20
393,3,405,435,840,승진,오프라인강의,비즈니스 시뮬레이션(Role Play),주5-6회,7.0,1,9,312,400,712,371,401,772,2,1979,68
394,3,295,295,590,자기계발,온라인강의,뉴스/이슈 기반 교재,주3-4회,6.0,1,8,287,232,519,289,239,528,1,1992,62
395,3,295,295,590,자기계발,오프라인강의,영상 교재,주1-2회,2.0,1,3,232,287,519,239,289,528,2,1986,62
396,3,382,345,727,자기계발,참고서,일반적인 영어 텍스트 기반 교재,주1-2회,1.0,1,6,380,297,677,381,306,687,1,1992,40
397,3,278,323,601,승진,참고서,뉴스/이슈 기반 교재,주3-4회,3.0,0,4,266,317,583,271,319,590,2,1995,11
398,3,495,495,990,자기계발,온라인강의,영상 교재,매일(주 7회),10.0,1,14,462,462,924,466,467,933,1,2004,57
399,3,373,387,760,자기계발,참고서,뉴스/이슈 기반 교재,주3-4회,3.0,1,5,310,324,634,341,355,696,2,2000,64
400,3,363,372,735,자기계발,온라인강의,뉴스/이슈 기반 교재,주1-2회,2.0,1,6,261,310,571,311,320,631,1,1989,104
401,3,427,464,891,자기계발,온라인강의,뉴스/이슈 기반 교재,주3-4회,4.0,1,6,313,416,729,380,417,797,2,1987,94
402,3,448,424,872,자기계발,온라인강의,비즈니스 시뮬레이션(Role Play),주5-6회,6.0,1,8,369,345,714,399,375,774,1,1984,98
403,3,395,395,790,자기계발,온라인강의,영상 교재,주5-6회,5.0,1,8,336,343,679,340,346,686,2,1992,104
404,3,395,395,790,승진,온라인강의,영상 교재,주5-6회,5.0,1,11,367,255,622,395,394,789,1,1998,1
405,3,347,390,737,승진,오프라인강의,비즈니스 시뮬레이션(Role Play),매일(주 7회),9.0,1,11,221,388,609,280,389,669,2,1983,68
406,3,371,345,716,자기계발,온라인강의,뉴스/이슈 기반 교재,주3-4회,3.0,1,8,368,245,613,370,251,621,1,1983,95
407,3,319,312,631,승진,온라인강의,뉴스/이슈 기반 교재,매일(주 7회),8.0,1,14,315,234,549,318,239,557,2,1995,74
408,3,298,309,607,자기계발,참고서,일반적인 영어 텍스트 기반 교재,주1-2회,2.0,1,3,251,304,555,259,308,567,1,1991,40
409,3,231,221,452,자기계발,오프라인강의,영상 교재,매일(주 7회),7.0,1,16,172,143,315,190,187,377,2,2001,75
410,3,436,472,908,승진,온라인강의,영상 교재,주5-6회,6.0,1,10,337,375,712,394,431,825,1,1995,83
411,3,331,311,642,자기계발,오프라인강의,일반적인 영어 텍스트 기반 교재,매일(주 7회),8.0,1,13,274,235,509,301,299,600,2,1992,42
412,3,263,357,620,자기계발,온라인강의,일반적인 영어 텍스트 기반 교재,주1-2회,2.0,0,3,252,351,603,258,354,612,1,2006,8
413,3,281,294,575,승진,온라인강의,영상 교재,매일(주 7회),9.0,1,19,119,151,270,241,231,472,2,1993,103
414,3,302,312,614,자기계발,온라인강의,뉴스/이슈 기반 교재,주1-2회,1.0,1,6,271,261,532,276,265,541,1,1979,73
415,3,464,470,934,자기계발,온라인강의,뉴스/이슈 기반 교재,주3-4회,4.0,1,7,368,374,742,417,423,840,2,1995,94
416,3,199,174,373,자기계발,오프라인강의,영상 교재,주5-6회,9.0,1,16,129,121,250,131,129,260,1,1987,113
417,3,458,454,912,자기계발,온라인강의,뉴스/이슈 기반 교재,주1-2회,2.0,1,3,414,405,819,416,412,828,2,1993,84
418,3,374,452,826,자기계발,온라인강의,뉴스/이슈 기반 교재,주5-6회,8.0,1,13,316,397,713,322,400,722,1,1988,104
419,3,487,479,966,승진,온라인강의,영상 교재,매일(주 7회),9.0,1,18,445,398,843,446,437,883,2,1992,83
420,3,495,495,990,자기계발,온라인강의,일반적인 영어 텍스트 기반 교재,주5-6회,6.0,1,12,487,458,945,488,466,954,1,1990,36
421,3,495,495,990,승진,오프라인강의,영상 교재,매일(주 7회),7.0,1,20,477,425,902,478,464,942,2,1985,48
422,3,495,495,990,자기계발,참고서,일반적인 영어 텍스트 기반 교재,주3-4회,4.0,1,5,440,467,907,490,491,981,1,2001,9
423,3,495,495,990,자기계발,오프라인강의,영상 교재,주5-6회,8.0,1,11,381,485,866,389,487,876,2,1985,114
424,3,495,495,990,승진,오프라인강의,비즈니스 시뮬레이션(Role Play),주1-2회,3.0,1,4,480,404,884,493,489,982,1,1981,8
425,3,260,258,518,승진,오프라인강의,비즈니스 시뮬레이션(Role Play),주1-2회,1.0,1,6,256,204,460,259,211,470,2,1987,48
426,3,478,480,958,승진,참고서,뉴스/이슈 기반 교재,주3-4회,4.0,1,7,334,447,781,446,448,894,1,1991,64
427,3,321,256,577,승진,오프라인강의,비즈니스 시뮬레이션(Role Play),매일(주 7회),10.0,1,17,284,248,532,287,252,539,2,1998,38
428,3,413,394,807,승진,오프라인강의,영상 교재,주1-2회,1.0,1,5,408,326,734,412,332,744,1,1996,63
429,3,495,495,990,자기계발,온라인강의,뉴스/이슈 기반 교재,매일(주 7회),7.0,1,20,370,466,836,472,467,939,2,1993,51
430,3,493,494,987,자기계발,오프라인강의,영상 교재,주5-6회,6.0,1,15,396,428,824,421,453,874,1,1980,113
431,3,423,460,883,자기계발,참고서,뉴스/이슈 기반 교재,매일(주 7회),10.0,1,16,342,458,800,350,459,809,2,2005,74
432,3,495,495,990,승진,온라인강의,영상 교재,주1-2회,1.0,1,5,406,382,788,489,465,954,1,1996,36
433,3,247,272,519,자기계발,참고서,일반적인 영어 텍스트 기반 교재,주1-2회,2.0,1,5,205,230,435,242,267,509,2,2000,10
434,3,495,495,990,승진,온라인강의,비즈니스 시뮬레이션(Role Play),주5-6회,5.0,1,17,456,471,927,493,494,987,1,1997,3
435,3,495,495,990,승진,참고서,일반적인 영어 텍스트 기반 교재,주1-2회,1.0,1,5,474,390,864,495,495,990,2,1995,0
436,3,361,339,700,자기계발,온라인강의,영상 교재,주5-6회,7.0,0,12,352,330,682,357,334,691,1,2001,9
437,3,444,490,934,자기계발,오프라인강의,뉴스/이슈 기반 교재,매일(주 7회),10.0,1,5,363,487,850,371,489,860,2,2003,74
438,3,495,471,966,자기계발,참고서,뉴스/이슈 기반 교재,매일(주 7회),10.0,1,14,495,358,853,495,367,862,1,1982,104
439,3,443,441,884,자기계발,오프라인강의,비즈니스 시뮬레이션(Role Play),주5-6회,5.0,1,9,327,439,766,346,440,786,2,1985,98
440,3,431,399,830,자기계발,온라인강의,영상 교재,주1-2회,2.0,1,4,428,329,757,430,337,767,1,2007,63
441,3,493,480,973,자기계발,온라인강의,뉴스/이슈 기반 교재,주3-4회,4.0,1,8,420,407,827,461,448,909,2,2000,64
442,3,467,446,913,자기계발,오프라인강의,비즈니스 시뮬레이션(Role Play),주3-4회,3.0,1,7,372,444,816,380,445,825,1,1990,88
443,3,495,495,990,승진,온라인강의,비즈니스 시뮬레이션(Role Play),매일(주 7회),9.0,1,15,430,475,905,494,495,989,2,1991,1
444,3,271,261,532,승진,참고서,일반적인 영어 텍스트 기반 교재,주5-6회,8.0,1,9,246,224,470,251,231,482,1,1997,50
445,3,395,395,790,자기계발,온라인강의,영상 교재,주5-6회,6.0,1,12,389,324,713,390,333,723,2,1997,67
446,3,224,347,571,자기계발,온라인강의,뉴스/이슈 기반 교재,매일(주 7회),10.0,0,14,214,340,554,219,344,563,1,1995,8
447,3,197,198,395,자기계발,온라인강의,일반적인 영어 텍스트 기반 교재,주1-2회,2.0,1,5,159,142,301,162,154,316,2,1979,79
448,3,321,328,649,승진,오프라인강의,영상 교재,주5-6회,7.0,1,12,280,271,551,301,300,601,1,1985,48
449,3,432,421,853,승진,참고서,일반적인 영어 텍스트 기반 교재,주1-2회,2.0,1,5,397,384,781,428,415,843,2,1987,10
450,3,377,328,705,자기계발,참고서,일반적인 영어 텍스트 기반 교재,주1-2회,4.0,1,1,373,311,684,376,319,695,1,2006,10
451,3,303,297,600,자기계발,온라인강의,일반적인 영어 텍스트 기반 교재,매일(주 7회),10.0,1,13,275,280,555,279,282,561,2,1977,39
452,3,339,341,680,자기계발,참고서,일반적인 영어 텍스트 기반 교재,주1-2회,2.0,1,3,301,265,566,338,302,640,1,1980,40
453,3,446,462,908,자기계발,온라인강의,영상 교재,주5-6회,6.0,1,12,365,381,746,390,406,796,2,1999,112
454,3,295,295,590,자기계발,온라인강의,영상 교재,주3-4회,3.0,1,6,245,251,496,249,256,505,1,1991,85
455,3,393,378,771,자기계발,참고서,일반적인 영어 텍스트 기반 교재,매일(주 7회),10.0,1,14,377,281,658,378,363,741,2,2005,30
456,3,330,328,658,승진,온라인강의,비즈니스 시뮬레이션(Role Play),주3-4회,3.0,1,5,281,280,561,320,293,613,1,1996,45
457,3,439,462,901,자기계발,온라인강의,영상 교재,매일(주 7회),10.0,1,18,381,344,725,382,406,788,2,2000,113
458,3,423,400,823,승진,온라인강의,영상 교재,주3-4회,4.0,1,8,419,323,742,422,328,750,1,1990,73
459,3,243,359,602,자기계발,오프라인강의,일반적인 영어 텍스트 기반 교재,주3-4회,5.0,1,10,218,351,569,241,359,600,2,1975,2
460,3,301,273,574,자기계발,온라인강의,영상 교재,매일(주 7회),9.0,1,16,213,197,410,236,211,447,1,1989,127
461,3,384,383,767,자기계발,참고서,일반적인 영어 텍스트 기반 교재,매일(주 7회),10.0,1,16,293,380,673,355,381,736,2,1999,31
462,3,326,364,690,자기계발,참고서,일반적인 영어 텍스트 기반 교재,주3-4회,5.0,1,12,278,338,616,301,339,640,1,1979,50
463,3,400,437,837,자기계발,온라인강의,뉴스/이슈 기반 교재,주1-2회,2.0,1,3,340,435,775,347,436,783,2,2007,54
464,3,425,391,816,자기계발,온라인강의,뉴스/이슈 기반 교재,매일(주 7회),9.0,1,18,370,334,704,373,339,712,1,1990,104
465,3,395,415,810,자기계발,참고서,일반적인 영어 텍스트 기반 교재,주1-2회,1.0,1,3,382,409,791,390,410,800,2,2003,10
466,3,383,382,765,자기계발,참고서,뉴스/이슈 기반 교재,매일(주 7회),10.0,1,14,371,279,650,372,288,660,1,1999,105
467,3,274,283,557,자기계발,참고서,뉴스/이슈 기반 교재,매일(주 7회),8.0,1,20,236,164,400,237,246,483,2,2002,74
468,3,355,379,734,자기계발,온라인강의,영상 교재,주1-2회,2.0,1,3,316,345,661,323,348,671,1,2000,63
469,3,383,375,758,승진,참고서,일반적인 영어 텍스트 기반 교재,주3-4회,3.0,1,7,322,312,634,374,364,738,2,1985,20
470,3,261,242,503,자기계발,오프라인강의,영상 교재,주5-6회,6.0,1,10,218,192,410,220,200,420,1,2006,83
471,3,242,265,507,승진,참고서,일반적인 영어 텍스트 기반 교재,주5-6회,6.0,1,8,220,247,467,227,250,477,2,1999,30
472,3,311,313,624,자기계발,온라인강의,뉴스/이슈 기반 교재,주1-2회,2.0,1,5,218,228,446,255,264,519,1,2001,105
473,3,309,339,648,자기계발,온라인강의,일반적인 영어 텍스트 기반 교재,주3-4회,3.0,1,9,294,325,619,301,335,636,2,1990,12
474,3,235,258,493,자기계발,오프라인강의,뉴스/이슈 기반 교재,매일(주 7회),8.0,1,12,232,136,368,233,155,388,1,1991,105
475,3,389,395,784,승진,참고서,일반적인 영어 텍스트 기반 교재,매일(주 7회),10.0,1,15,344,350,694,374,380,754,2,1994,30
476,3,296,349,645,자기계발,온라인강의,뉴스/이슈 기반 교재,주3-4회,3.0,0,7,283,343,626,289,346,635,1,1984,10
477,3,395,373,768,자기계발,오프라인강의,비즈니스 시뮬레이션(Role Play),매일(주 7회),10.0,1,16,291,245,536,310,295,605,2,1986,163
478,3,396,394,790,승진,온라인강의,비즈니스 시뮬레이션(Role Play),주3-4회,3.0,1,7,337,335,672,367,365,732,1,2000,58
479,3,256,210,466,승진,온라인강의,비즈니스 시뮬레이션(Role Play),매일(주 7회),9.0,1,16,242,168,410,243,182,425,2,1996,41
480,3,308,294,602,자기계발,온라인강의,뉴스/이슈 기반 교재,주5-6회,5.0,1,17,219,286,505,251,301,552,1,2004,50
481,3,315,328,643,자기계발,온라인강의,비즈니스 시뮬레이션(Role Play),주3-4회,3.0,1,8,287,319,606,301,327,628,2,1988,15
482,3,355,355,710,자기계발,온라인강의,영상 교재,주1-2회,1.0,1,5,275,329,604,294,337,631,1,1987,79
483,3,474,453,927,자기계발,오프라인강의,영상 교재,주3-4회,5.0,1,7,453,327,780,454,400,854,2,2003,73
484,3,380,370,750,자기계발,참고서,일반적인 영어 텍스트 기반 교재,주5-6회,9.0,1,11,373,268,641,374,365,739,1,1998,11
485,3,484,482,966,자기계발,오프라인강의,영상 교재,주3-4회,4.0,1,6,328,451,779,411,452,863,2,1992,103
486,3,310,321,631,승진,참고서,일반적인 영어 텍스트 기반 교재,주3-4회,3.0,1,6,228,210,438,230,219,449,1,1981,182
487,3,431,432,863,자기계발,온라인강의,영상 교재,매일(주 7회),9.0,1,18,371,371,742,375,376,751,2,1974,112
488,3,252,227,479,승진,참고서,일반적인 영어 텍스트 기반 교재,주5-6회,5.0,1,10,234,206,440,237,212,449,1,1989,30
489,3,431,413,844,자기계발,오프라인강의,일반적인 영어 텍스트 기반 교재,주1-2회,2.0,1,3,396,340,736,430,374,804,2,1978,40
490,3,362,341,703,자기계발,참고서,일반적인 영어 텍스트 기반 교재,주5-6회,6.0,1,9,286,263,549,333,310,643,1,1992,60
491,3,287,330,617,승진,참고서,일반적인 영어 텍스트 기반 교재,매일(주 7회),9.0,1,17,269,331,600,271,338,609,2,1985,8
492,3,301,321,622,자기계발,오프라인강의,비즈니스 시뮬레이션(Role Play),매일(주 7회),10.0,1,16,204,201,405,241,238,479,1,1980,143
493,3,420,427,847,자기계발,참고서,뉴스/이슈 기반 교재,매일(주 7회),8.0,1,19,378,388,766,383,390,773,2,2002,74
494,3,301,310,611,승진,참고서,뉴스/이슈 기반 교재,주3-4회,3.0,1,6,276,251,527,299,301,600,1,1996,11
495,3,267,275,542,자기계발,온라인강의,영상 교재,주1-2회,0.0,1,5,221,229,450,236,244,480,2,2007,62
496,3,364,336,700,자기계발,온라인강의,일반적인 영어 텍스트 기반 교재,매일(주 7회),10.0,1,13,347,315,662,349,321,670,1,2006,30
497,3,187,252,439,승진,온라인강의,비즈니스 시뮬레이션(Role Play),매일(주 7회),9.0,1,17,112,250,362,120,251,371,2,1988,68
498,3,255,167,422,자기계발,오프라인강의,일반적인 영어 텍스트 기반 교재,주1-2회,0.0,1,4,252,150,402,254,158,412,1,2006,10
499,3,422,370,792,자기계발,오프라인강의,비즈니스 시뮬레이션(Role Play),주3-4회,4.0,1,7,371,324,695,378,326,704,2,1990,88
500,3,235,226,461,승진,오프라인강의,비즈니스 시뮬레이션(Role Play),주5-6회,7.0,1,15,169,188,357,172,190,362,1,1984,99
